00000000000000000000000000000000000000000000
00000000000000000000000000000000000000000000
00000000011111111111111111111111111000000000
00000000010000000000000000000100000000000000
00000000010000000000000000000111000000000000
00000000010000000000000000000100000000000000
00000111111111000000000000000100000000000000
00000000000000000000000000000100000000000000
00000000000000000000000000000100000000000000
00000111111111000000000000000000000000000000
00000122222221000000000000000000000000000000
00000122222221000000000000000000000000000000
00000122222221000000000000000000000000000000
00000122222221000000000000000000000000000000
00000111111111000000000000000000000000000000
00000000000000000000000000000000000000000000
